1111111111111111111111111111
100000000000000000000C000001
10C0011000111001110011100C01
101C00100000100001000010C101
1011001000111001110000101101
10100C10000010000100001001C1
1000011100111001110000100001
1P000000000C0000C00000000001
1110001111110001111111000111
1110001111110001111111000111
1E0000000000000000000C000001
10C0011000111001110011100C01
101C00100000100001000010C101
1011001000111001110000101101
10100C10000010000100001001C1
1000011100111001110000100001
10000000000C0000C00000000001
1111111111111111111111111111